1111111111111111111111111111111111
1E0000000000000C00000C000000000001
1010010100100000101001000000010101
101001001010101000100100C000010101
1P00C0000C00C0000000000000000000C1
1010010010101010001001000000010101
10100101001000001010010000C0010101
1111111111111111111111111111111111