1111111111111111111111111111111111
1E000000000000AC00000C000000000001
1A10010100100000101001000000010101
101001001010101000100100C000010101
1P00C0000C00C0000000000000000000C1
10100100101010100010010000A0010101
101A0101001000001010010000C0010101
1111111111111111111111111111111111