111111111111111
1E01000100000E1
100100010000001
100C0001000C001
10000C000100001
100001111100001
1P0C11E000000C1
111111111111111
